F	70,70,70
C	12,15,50
NO	assets/stone.xpm
EA	assets/cobbled_deepslate.xpm
SO	assets/cobblestone.xpm
WE	assets/mossy_cobblestone.xpm



111111111111111
100000000000001
100000000000001
111P11111111111
100000000000001
100000000000001
1111111P1111111
100000000000001
1000000N0000001
111111111111111