
F	0,0,0
C	225,30,258
NO	assets/north.xpm
EA	assets/east.xpm
SO	assets/south.xpm
WE	assets/west.xpm



        1111111111111111111111111
        1000000000110000000000001
        101100000111000000E000001
        1001000000000000000000001
111111111011000001110000000000001
100000000011000001110111111111111
111101111111110011100000010001
11110111111111011101010010001
 1000000110101011100000010001
10000000000000001101010010001
1100000111010101111101111000111
11110111 1110101 101111010001
11 11111 1111111 1111 11111111