
   NO ./path_to_the_east_texture

     F    0,0,0
C     225,30,255






EA ./path_to_the_east_texture
SO ./path_to_the_south_texture
WE ./path_to_the_west_texture






        1111111111111111111111111
        1000000000110000000000001
        1011000001110000000000000
        1001000000000000000000001
111111111011000001110000000000001
100000000011000001110111111111111
11110111111111011100000010001                       111
11110111111111011101010010001                       101
 1000000110101011100000010001                       101
10000000000000000110000001001                       111
10000000000000001101010010001
11000001110101011111011110N0111
11110111 1110101 101111010001
11 11111 1111111 1111 11111111