
F	0,0,0
C	225,30,255
NO	assets/north.xpm
EA	assets/east.xpm
SO	assets/south.xpm
WE	assets/west.xpm



111111111111111
100000000000001
100000100100001
100000000000001
1000000N0000001
100000000000001
111111111111111
