F	190,190,190
C	0, 127, 190
NO	assets/pink1.xpm
EA	assets/pink2.xpm
SO	assets/pink3.xpm
WE	assets/pink4.xpm

        1111111111111111111111111
        1000000000110000000000001
        1011000001110000000000001
        1001000000000000000000001
111111111011000001110000000000001
100000000011000001110111111111111
111101111111110011100000000001
11110111111111011101010010001
 1000000110101011100000010001
10000000000000001101010010001    1111
1100000111010101111101111N0111  1001
11110111 1110101 101111010001   1111
11 11111 1111111 1111 11111111