





NO	assets/stone.xpm
EA	assets/cobbled_deepslate.xpm
SO	assets/cobblestone.xpm
WE	assets/mossy_cobblestone.xpm

F 70,70,70
C 70,70,70

111111111111111
100000000000001
100000100100001
10000000N000001
100100000000001
100000000001001
111111111111111