C 120,150,150
F 70,70,70
NO	assets/stone.xpm
EA	assets/cobbled_deepslate.xpm
SO	assets/cobblestone.xpm
WE	assets/mossy_cobblestone.xpm

111111111111111
1000000S0000001
100000100100001
100000000000001
100100000000001
100000000001001
111111111111111